AatII	GACGT-C
Acc65I	G-GTACC
AccI	GT-MKAC
AclI	AA-CGTT
AciI	C-CGC
AfeI	AGC-GCT
AflII	C-TTAAG
AflIII	A-CRYGT
AgeI	A-CCGGT
AhdI	GACNNN-NNGTC
AleI	CACNN-NNGTG
AluI	AG-CT
AlwNI	CAGNNN-CTG
ApaI	GGGCC-C
ApaLI	G-TGCAC
ApeKI	G-CWGC
ApoI	R-AATTY
AscI	GG-CGCGCC
AseI	AT-TAAT
AsiSI	GCGAT-CGC
AvaI	C-YCGRG
AvaII	G-GWCC
AvrII	C-CTAGG
BaeGI	GKGCM-C
BamHI	G-GATCC
BanI	G-GYRCC
BanII	GRGCY-C
BclI	T-GATCA
BfaI	C-TAG
BfuCI	-GATC
BglI	GCCNNNN-NGGC
BglII	A-GATCT
BlpI	GC-TNAGC
BmtI	GCTAG-C
BsaAI	YAC-GTR
BsaBI	GATNN-NNATC
BsaHI	GR-CGYC
BsaJI	C-CNNGG
BsaWI	W-CCGGW
BsiEI	CGRY-CG
BsiHKAI	GWGCW-C
BsiWI	C-GTACG
BslI	CCNNNNN-NNGG
BsoBI	C-YCGRG
Bsp1286I	GDGCH-C
BspDI	AT-CGAT
BspEI	T-CCGGA
BspHI	T-CATGA
BsrFI	R-CCGGY
BsrGI	T-GTACA
BssHII	G-CGCGC
BssKI	-CCNGG
BstAPI	GCANNNN-NTGC
BstBI	TT-CGAA
BstEII	G-GTNACC
BstNI	CC-WGG
BstUI	CG-CG
BstXI	CCANNNNN-NTGG
BstYI	R-GATCY
BstZ17I	GTA-TAC
Bsu36I	CC-TNAGG
BtgI	C-CRYGG
Cac8I	GCN-NGC
ClaI	AT-CGAT
CviAII	C-ATG
CviKI-1	RG-CY
CviQI	G-TAC
DdeI	C-TNAG
DpnI	GA-TC
DpnII	-GATC
DraI	TTT-AAA
DraIII	CACNNN-GTG
DrdI	GACNNNN-NNGTC
EaeI	Y-GGCCR
EagI	C-GGCCG
Eco53kI	GAG-CTC
EcoNI	CCTNN-NNNAGG
EcoO109I	RG-GNCCY
EcoRI	G-AATTC
EcoRV	GAT-ATC
FatI	-CATG
Fnu4HI	GC-NGC
FseI	GGCCGG-CC
FspI	TGC-GCA
HaeII	RGCGC-Y
HaeIII	GG-CC
HhaI	GCG-C
HincII	GTY-RAC
HindIII	A-AGCTT
HinfI	G-ANTC
HinP1I	G-CGC
HpaI	GTT-AAC
HpaII	C-CGG
Hpy166II	GTN-NAC
Hpy188I	TCN-GA
Hpy188III	TC-NNGA
Hpy99I	CGWCG-
HpyCH4III	ACN-GT
HpyCH4IV	A-CGT
HpyCH4V	TG-CA
KasI	G-GCGCC
KpnI	GGTAC-C
MboI	-GATC
MfeI	C-AATTG
MluCI	-AATT
MluI	A-CGCGT
MscI	TGG-CCA
MseI	T-TAA
MslI	CAYNN-NNRTG
MspA1I	CMG-CKG
MspI	C-CGG
MwoI	GCNNNNN-NNGC
NaeI	GCC-GGC
NarI	GG-CGCC
NciI	CC-SGG
NcoI	C-CATGG
NdeI	CA-TATG
NgoMIV	G-CCGGC
NheI	G-CTAGC
NlaIII	CATG-
NlaIV	GGN-NCC
NotI	GC-GGCCGC
NruI	TCG-CGA
NsiI	ATGCA-T
NspI	RCATG-Y
PacI	TTAAT-TAA
PaeR7I	C-TCGAG
PciI	A-CATGT
PflFI	GACN-NNGTC
PflMI	CCANNNN-NTGG
PhoI	GG-CC
PluTI	GGCGC-C
PmeI	GTTT-AAAC
PmlI	CAC-GTG
PpuMI	RG-GWCCY
PshAI	GACNN-NNGTC
PsiI	TTA-TAA
PspGI	-CCWGG
PspOMI	G-GGCCC
PspXI	VC-TCGAGB
PstI	CTGCA-G
PvuI	CGAT-CG
PvuII	CAG-CTG
RsaI	GT-AC
RsrII	CG-GWCCG
SacI	GAGCT-C
SacII	CCGC-GG
SalI	G-TCGAC
Sau3AI	-GATC
Sau96I	G-GNCC
SbfI	CCTGCA-GG
ScaI	AGT-ACT
ScrFI	CC-NGG
SexAI	A-CCWGGT
SfcI	C-TRYAG
SfiI	GGCCNNNN-NGGCC
SfoI	GGC-GCC
SgrAI	CR-CCGGYG
SmaI	CCC-GGG
SmlI	C-TYRAG
SnaBI	TAC-GTA
SpeI	A-CTAGT
SphI	GCATG-C
SspI	AAT-ATT
StuI	AGG-CCT
StyD4I	-CCNGG
StyI	C-CWWGG
SwaI	ATTT-AAAT
TaqI	T-CGA
TfiI	G-AWTC
TseI	G-CWGC
Tsp45I	-GTSAC
TspMI	C-CCGGG
TspRI	CASTGNN-
Tth111I	GACN-NNGTC
XbaI	T-CTAGA
XcmI	CCANNNNN-NNNNTGG
XhoI	C-TCGAG
XmaI	C-CCGGG
XmnI	GAANN-NNTTC
ZraI	GAC-GTC
